7,7,7,7,7,7,7,7,7,7,7,7,7,7,7,7,7,7,7,7
7,7,7,7,7,7,7,7,7,7,7,7,7,7,7,7,7,7,7,7
7,7,7,7,7,7,7,7,7,7,7,7,7,7,7,7,7,7,7,7
7,7,7,7,7,7,7,7,7,7,7,7,7,7,7,7,7,7,7,7
7,7,7,7,7,7,7,7,7,7,7,7,7,7,7,7,7,7,7,7
7,7,7,7,7,7,7,7,7,7,7,7,7,7,7,7,7,7,7,7
7,7,7,7,7,7,0,0,0,11,0,0,0,12,7,7,7,7,7,7
7,7,7,7,7,7,10,0,7,7,7,0,10,0,7,7,7,7,7,7
7,7,7,7,7,7,0,0,9,0,0,0,0,0,7,7,7,7,7,7
7,7,7,7,7,7,0,8,0,12,0,0,0,0,7,7,7,7,7,7
7,7,7,7,7,7,0,0,0,0,0,0,0,0,7,7,7,7,7,7
7,7,7,7,7,7,0,0,0,10,0,0,0,0,7,7,7,7,7,7
7,7,7,7,7,7,0,0,9,0,0,0,0,0,7,7,7,7,7,7
7,7,7,7,7,7,12,0,0,0,0,0,0,12,7,7,7,7,7,7
7,7,7,7,7,7,7,7,7,7,7,7,7,7,7,7,7,7,7,7
7,7,7,7,7,7,7,7,7,7,7,7,7,7,7,7,7,7,7,7
7,7,7,7,7,7,7,7,7,7,7,7,7,7,7,7,7,7,7,7
7,7,7,7,7,7,7,7,7,7,7,7,7,7,7,7,7,7,7,7
7,7,7,7,7,7,7,7,7,7,7,7,7,7,7,7,7,7,7,7
7,7,7,7,7,7,7,7,7,7,7,7,7,7,7,7,7,7,7,7
